0 0 0 0 0 0 0 0 0 0 0 0 0 0 0 0 0 0 0 0 0 0 0 0
0 0 0 0 0 0 0 0 0 0 0 0 0 0 0 0 0 0 0 0 0 0 0 0
0 0 0 0 0 0 0 0 0 0 0 0 0 0 0 0 0 0 0 0 0 0 0 0
0 0 0 0 0 0 0 0 0 0 0 0 0 0 0 0 0 0 0 0 0 0 0 0
0 0 0 0 0 0 0 0 0 0 0 0 0 0 0 0 0 0 0 0 0 0 0 0
0 0 0 0 11 11 11 11 11 0 0 0 0 0 0 0 11 11 11 11 11 0 0 0
0 0 0 11 11 0 0 0 11 11 0 0 0 0 0 11 11 0 0 0 11 11 0 0
11 11 11 11 0 0 0 0 0 11 11 0 0 0 11 11 0 0 0 0 0 11 11 11
0 0 0 0 0 0 10 0 0 0 11 11 11 11 11 0 0 0 10 0 0 0 0 0
0 0 0 0 0 10 10 10 0 0 0 11 0 11 0 0 0 10 10 10 0 0 0 0
10 10 10 10 10 10 10 10 10 0 0 0 0 0 0 0 10 10 10 10 10 10 10 10
10 10 10 10 10 10 10 10 10 10 0 0 11 0 0 10 10 10 10 10 10 10 10 10
10 10 10 10 10 10 10 10 10 10 10 0 0 0 10 10 10 10 10 10 10 10 10 10
10 10 10 10 10 10 10 10 10 10 10 10 0 10 10 10 10 10 10 10 10 10 10 10
10 10 10 10 10 10 10 10 10 10 10 10 10 10 10 10 10 10 10 10 10 10 10 10
10 10 10 10 10 10 10 10 10 10 10 10 10 10 10 10 10 10 10 10 10 10 10 10